1111111111111111111111111111111
1000000000000000C00100000000001
1000001000010111111000000C00001
1000000100010000000000000000001
1000U001000000100P0000U00E00001
1000000100000000000101000000001
1000011100000001000100000001101
1000010000110000000100000010001
1000000000C100U000000000E000001
1000000000010000000110000001001
1111111111111111111111111111111